______________________________________________________
|..........~~~~.......................................|
|............~~~...............................❀......|
|.............~~~~....................................|
|...............~~~~~........❀........................|
|................~~~~~................~#~.............|
|.................#####..............~~#~~............|
|..................~~~~~..........~~~~~#~~~~~.........>
|...................~~~~~......~~~~~....❀...~~~~......|
|.......................~~~~~..............~~~~...~~~~|
|_____________________________________________________|
